A00000000000000000000000000000000000000B
0000000000000000000000000000000000000000
0000000000000000000000000000000000000000
0000000000000000000000000000000000000000
0000000000000000000000000000000000000000
0000000000000000000000000000000000000000
0000000000000001000000100000000000000000
0000000000000010000000010000000000000000
0000000000000100000000001000000000000000
0000000000001000000000000100000000000000
0000000000010000000000000010000000000000
0000000000100000000000000001000000000000
0000000001000000000000000000100000000000
0000000010000000000000000000010000000000
0000000000000000000000000000000000000000
0000000000000000000000000000000000000000
0000000000000000000000000000000000000000
0000000010000000000000000000010000000000
0000000001000000000000000000100000000000
0000000000100000000000000001000000000000
0000000000010000000000000010000000000000
0000000000001000000000000100000000000000
0000000000000100000000001000000000000000
0000000000000010000000010000000000000000
0000000000000001000000100000000000000000
0000000000000010000000010000000000000000
0000000000000100000000001000000000000000
0011110011111100000000001111100111111100
0000000000000000000000000000000000000000
00000000000000000O0000000000000000000000
